
%%%%%%%%%%%%%%%%%
%P              %
%               %
%               %
%               %
%       %       %
%       %       %
%    %%%%%%%    %
%       %       %
%       %       %
%               %
%               %
%               %
%              .%
%%%%%%%%%%%%%%%%%